R 1240 720
NO textures/yellow_brick.xpm
SO textures/grey_brick.xpm
WE textures/wood.xpm
EA textures/red_brick.xpm
S textures/sprites/barrel.xpm
F 230, 198, 110
C 152, 224, 235

        11111111111111111111111111111111111111
        1000000000112000000000000000000001
        1011000001110000002000000000000001
        1001000000000000000000000000000001
111111111011000001110000000000000000000001
100000000011000001110000000000111111111111
11110111111111011100000010000000000021111111111111111111111111
11110111111111011101010010000000000000000000000000000000000001
11000000112101011100000010000000000001111111111111110011111111
1200000000000002110000000000000000000111111111111111001111111
1000000000000000110000000000000000000111111111111111002111111
1000200E00000000210000000000000000000111111111111111001111111
1000000000000000110000000000000000000111111111111111001111111
1000000000000000110000000000000000000111111111111111001111111
1200000000000002112121201000000000000111111111111111002111111
1100000111210101111101111000111111111111111111111111001111111
1111011111110101110111121000000000000000000000000000001111111
1000000000000000110000000000000000000111111111111111001111111
1000000000000000110000000000000000000111111111111111001111111
1000000000000000110000000000000000000111111111111111002111111
1000000000000000110000000000000000000111111111111111001111111
1000000000000000110000000000000000000111111111111111001111111
1000000000000000110101001000000000000111111111111111001111111
1111011111111111111111111111110000000000000000000000002111111
1000000000000000110000000000000000000111111111111111001111111
1000000000000000110000000000000000000111111111111111001111111
1000000000000000110000000000000000000111111111111111001111111
1000000000000000110000000000000000000111111111111111002111111
1000000000000000110000000000000000000111111111111111001111111
1000000000000000110101001000000000000211111111111111001111111
1111001111110000110101001000000000000111111111111111002111111
1000000000210000110101001000000000000111111111111111001111111
1000000000010000110101001000000000000111111111111111001111111
1000000000010000110101001000000000000111111111111111002111111
1000000000010000110101001000000000000111111111111111001111111
1000000000010000110101001000000000000211111111111111001111111
1100000000010000110101001000000000000111111111111111001111111
1200000000010000110101001000000000000111111111111111002111111
1100000000010000110101001000000000000211111111111111001111111
1000000000010000110101001000000000000111111111111111001111111
1000000000010000110101001000000000000111111111111111001111111
1000000000010000110101001000000000000111111111111111002111111
1000000000010000110101001000000000000211111111111111001111111
1100000000010000110101001000000000000111111111111111001111111
1200000000012000110101001000000000000111111111111111001111111
1100000000000000000000000000000000000111111111111111002111111
1000000000012000110101001000000000000211111111111111001111111
1000000000010000110101001000000000000111111111111111001111111
1000000000010000110101001000000000000111111111111111001111111
1000000000010000210101001000000000000211111111111111002111111
1000000000010000110101001000000000000111111111111111001111111
1000000000010000110101001000000000000111111111111111001111111
1000000000010000110101001000000000000211111111111111001111111
1000000000010000210101001000000000000111111111111111001111111
1000000000010000110101001000000000000211111111111111001111111
1000000000010000110101001000000000000111111111111111001111111
1200000000210000110101001000000000000000000000000000001111111
1111111111111111111111111111111111111111111111111111111111111