R  1240 720

SO          textures/grey_brick.xpm

WE      textures/wood.xpm

NO      textures/yellow_brick.XPM

EA      textures/red_brick.xpm

S  textures/sprites/barrel.xpm

F       92, 191, 120

C 164, 237, 233

11111111111111111111111
10000000000000002000001
1000000E000002000002001
11000000000000002000001
10000000000100100000001
11111100000000000000001
10000000000000000000001
10000000000000000000001
1111111111110011111111111111111111111111
1000000222220000000000000000000000000021
1000000000000000000000000000000000002221
1111100000000000000000000000000000002211
1000000000000000000000000000000000000021
1000000002000022000000000000000000000221
1000000000000000000000000202000000000001
1200000000000000000000000000000000002221
1220000002000000000000000000000000000021
1111111111110011111111111111111111111111
1111111111110011111111111111111111111111
1111111111110011111111111111111111111111
1111111111110000000000000000000000000111
1111111111110011111111111111111111110211
1111111111110011111111111111111111110111
1111111111110011111111111111111111110111
1111111111112011111111111111111111110111
1111111111110010000000000000001111110111
1111111111110000000002000000001111110111
1111111111112000000000000000001111110111
1111111111110010000000000000000000000111
1111111111110000000000000200000111111111
1111111111110011111111111111111111111111
1111111111111111111111111111111111111111
